#####
#O  #
#X#P#
#   #
#####
