  ####
  #  #######
 ##        #
##  ### # X##
# OOO # X X #
# O#O ##X X #
# OOO #   X #
#     # XPX #
#    ##     #
#############
