############
#        O #
#   P   ####
#      X   #
############
